#################
#        G#     #
# ######### # # #
#    T#   # #T# #
##### # # # # # #
#       #     # #
####### ####### #
#      S      #G#
# ####### # # ###
# #       #T# # #
# # ####### # # #
# #         #  T#
# ######### # # #
#  T G#G    # # #
# ########### # #
#             #G#
#################