#################
# . # . . . . . #
#.#.#.###.#####.#
# # . .T# # . . #
#.#####.#.#.###.#
# .S# # . .T.G# #
#.#.#.#####.###.#
# # . # . # # . #
#.#.#.#.#.#.###.#
# # # # # # # # #
#.###.#.#.#.#.#.#
# . . . # # #G. #
#.#######.#.###.#
# . . . # #T. #T#
#.###.#.#####.#.#
# . # # #G. . #G#
#################